0 0 0 0 0 0 0 0 0 0 0 0 0 0 0 0 0 0 0 0 0 0 0 0 0
0 0 0 0 0 0 0 0 0 0 0 0 0 0 0 0 0 0 0 0 0 0 0 0 0
0 0 0 0 0 0 0 0 0 0 0 0 0 0 0 0 0 0 0 0 0 0 0 0 0
0 0 0 0 0 0 0 0 0 0 0 0 0 0 0 0 0 0 0 0 0 0 0 0 0
0 0 0 0 0 0 0 0 0 0 0 0 0 0 0 0 0 0 0 0 0 0 0 0 0
0 0 0 0 0 0 0 0 0 0 0 0 0 0 0 0 0 0 0 0 0 0 0 0 0
0 0 0 0 0 0 0 0 0 0 0 0 0 0 0 0 0 0 0 0 0 0 0 0 0
0 0 0 0 0 0 0 0 0 0 0 0 0 0 0 0 0 0 0 0 0 0 0 0 0
5 5 5 5 5 5 5 0 0 0 0 0 0 0 0 0 0 0 5 5 5 5 5 5 5
1 1 1 1 1 1 5 0 0 0 0 0 0 0 0 0 0 0 5 3 3 3 3 3 3
1 1 1 1 1 1 5 0 0 0 0 0 0 0 0 0 0 0 5 3 3 3 3 3 3
1 1 1 1 1 1 5 0 0 0 0 0 0 0 0 0 0 0 5 3 3 3 3 3 3
1 1 1 1 1 1 5 5 5 5 2 2 2 2 2 5 5 5 5 3 3 3 3 3 3
1 1 1 1 1 1 2 2 2 2 2 2 2 2 2 2 2 2 2 3 3 3 3 3 3
1 1 1 1 1 1 2 2 2 2 2 2 2 2 2 2 2 2 2 3 3 3 3 3 3
1 1 1 1 1 1 5 5 5 5 2 2 2 2 2 5 5 5 5 3 3 3 3 3 3
1 1 1 1 1 1 5 0 0 0 0 0 0 0 0 0 0 0 5 3 3 3 3 3 3
1 1 1 1 1 1 5 0 0 0 0 0 0 0 0 0 0 0 5 3 3 3 3 3 3
1 1 1 1 1 1 5 0 0 0 0 0 0 0 0 0 0 0 5 3 3 3 3 3 3
5 5 5 5 5 5 5 0 0 0 4 4 4 4 4 0 0 0 5 5 5 5 5 5 5
0 0 0 0 0 0 0 0 0 0 0 0 0 0 0 0 0 0 0 0 0 0 0 0 0
0 0 0 0 0 0 0 0 0 0 0 0 0 0 0 0 0 0 0 0 0 0 0 0 0
0 0 0 0 0 0 0 0 0 0 5 5 5 5 5 0 0 0 0 0 0 0 0 0 0
0 0 0 0 0 0 0 0 0 0 5 0 0 0 5 0 0 0 0 0 0 0 0 0 0
0 0 0 0 0 0 0 0 0 0 5 0 6 0 5 0 0 0 0 0 0 0 0 0 0
